########
#......#..
#..##..#.
#..##..##.
#.#@...##
#..#######
#........#
#........#
#........#
########.#
........##