####..####
#........#
#..@.....#
#........#
 .....

#........#
#........#
#........#
####..####